34444444444444444444444444444444444444444444444444444444444444444443
3@211111111111111111111111111111111111111111111111115111111111111213
32333332111123333312333332151123333311111111111111111111111111111213
32111112333321111122111112333321111121111111111111111111111111111213
32111112111121133322111112111121133321111111111111111111111111111213
32333333333321111122333333333321111121111111111111111111111111111213
32131111311321111122131111311321111121111111111111111111111111111213
33233333333333323233233333333333323231111111111111111111111111111213
31231113111131323211231113111131323211111111111111111111111111111213
31232313333331323211232313333331323211111111111111111111111111111213
31232311111111323211232311111111323211111111111111111111111111111213
3123231E233211323211232311233211323211111111111111111111111111111213
352121112112E11212e12121112112111212e1111E111111E1111115111111111213
33333333333333333333333333333333333333333333333333333333333333333333