1513331111123315133311111233
2133131333323315133311111233
2444444311123315133311111233
3311111112323315133311111233
3111@11311323315133311111233
3331133311323315133311111233
1131131111323315133311111233
1331331213323315133311111233
1311111133123315133311111233
1111111331123315133311111233
1333333311123315133311111233
1111111111123315133311111233
3333333333333315133311111233