1513331111123
2133131333323
2444444311123
3311111112323
3111@11311323
3331133311323
1131131111323
1331331213323
1311111133123
1111111331123
1333333311123
1111111111123
3333333333333