11133311111
11331313333
13311333113
33111111123
3111@113113
33311333113
11311311113
13313313133
13111111331
11111113311
13333333111